11111111111 11111111111
1o....1.........1.....1
1.111.1.1111111.1.111.1
1.1...1.........1...1.1
1.1.111.111.111.111.1.1
1....................o1
11111.11111111111.11111
1...1.............1...1
1.1.1.1.1111111.1.1.1.1
1.1.1...1     1...1.1.1
1.1.1.1.1111111.1.1.1.1
1.....1.       .1.....1
1.11111.1111111.11111.1
1.....................1
1111111.1111111.1111111
1...1.............1..o1
1.1.1.1.1.111.1.1.1.1.1
1.1...1.1.....1.1...1.1
1.11111.111.111.11111.1
1.........1.1.........1
1.111.111.1.1.111.111.1
1o....................1
11111111111 11111111111
